#####################
##Oooooooo#Oooooooo##
##o######o#o######@##
##oooooooo#oooooooo##
##o######o#o######@##
##oooo#ooo#ooo#oooo##
#####o###@#o###o#####
#@@@#o#@@@R@@@#o#@@@#
#####o#@##D##@#o#####
1@@S@o#@#BPY#@#o@@@@1
#####o#@#####@#o#####
#@@@#o#@@@@@@@#o#@@@#
#####o#@#####@#0#####
##oooooooo#oooooooo##
##o######o#o######@##
##oooooooo#oooooooo##
##o######o#o######@##
##oooO#ooo#ooo#Oooo##
##o######o#o######o##
##ooooooooooooooooo##
#####################