@###################@
@#oooooooo#oooooooo#@
@#O##o###o#o###o##O#@
@#ooooooooooooooooo#@
@#o##o#o#####o#o##o#@
@#oooo#ooo#ooo#oooo#@
@####o###@#o###o####@
@@@@#o#@@@R@@@#o#@@@@
@####o#@##D##@#o####@
1@@S@o#@##@#o@@@@1
@####o#@#####@#o####@
@@@@#o#@@@@@@@#o#@@@@
@####o#@#####@#0####@
@#oooooooo#oooooooo#@
@#o##o###o#o###o##o#@
@#Oo#ooooo@ooooo#oO#@
@##o#o#o#####o#o#o##@
@#oooo#ooo#ooo#oooo#@
@#o######o#o######o#@
@#ooooooooooooooooo#@
@###################@